1111111111
1110000001
11P0010001
1000000001
1001000101
1001000001
1010001111
1001000E11
1000001111
1111111111
