11111
1P001
10111
1C1E1
11111
