11111
1P0E1
10101
10011
1C0E1
11111
