11111
100011
10101
10011
10001
11111
