11111
100011
101001
100011
10001
11111