1111111111
1110000001
11P0010001
10000C0001
1001000101
1001000001
101C001111
1001000011
1000001111
1111111111
