1111111111
1P000000C1
1000000111
1111101111
1000000111
1C000001E1
1111111111
