1111111111111111111111111111111111111111
1111111111111111111111111111111111111111
11P0000000000001111111111110000000000001
110000000010000000001111100011100U000001
11111110011110011110000000000111100000G1
1111111111111111110000000011111111111111
111111111111111100000U000000011111111111
11111111111110000000000G0000001111111111
1111111111111111000U00000000000111110E01
1111111111000111000000000000100111110001
11111110000101100111000111111D0000000011
1111110011110000111100011111111111111111
1111110111111111111110U00111111111111111
1111100111111111111000000000111111111111
1111100111111111100000000000001111111111
1110U00001111111000000000000000011111111
1100000011111111000000000000000001111111
1K00000111111111111111C000D000A111111111
1111111111111111111111111111111111111111
1111111111111111111111111111111111111111
