1111111111
1111P01111
1110000111
11A000UC11
1000110001
1001111001
1001111001
1000110001
11KU000G11
1110000111
1111DE1111
1111111111
