11111111111111111111
1P11111100C000000001
10001110000011000111
1000011000000C101001
100001001000110000E1
10010001100000001001
11111011110000000111
10000000001100000001
1C000000001C00000001
11111111111111111111
