11111111111111111111
1P0000000000000000G1
11000000000000011111
11110000000001111111
111111U0000001111111
111000000000001111C1
11110000000000111001
11010000000000011001
10A11000000000001101
10111100000000001001
10111110000000111001
10011110000001110001
10001100000011000001
10000000000110000001
11000000001100001001
111U0000011ED0001001
111K0000011100010001
11111100000111110001
11111111000000000001
11111111111111111111
