1111111111
1111111111
11111C1111
111A001111
1P00000111
11000U0011
11G0000K11
11110D0111
11111E1111
1111111111
